--*-------
------***-
----------
--*-**----
-------*-*
-**-------
-------*--
-*-----*--
-*--*--*--
----------